MAZE: "mylevel",' '
INIT_MAP:solidfill,' '
GEOMETRY:center,center
MAP
-------
|.....|
|.....|
|.....|
|.....|
|.....|
|.....|
|.....|
-------
ENDMAP
REGION:(0,0,6,8),lit,"ordinary"
BRANCH:(3,7,3,7),(0,0,0,0)
OBJECT:('/',"magic missile"),(3,7)
MONSTER: ('F', "lichen"),(1,3),asleep
MONSTER: ('F', "red mold"),(1,4),asleep
MONSTER: ('x', "grid bug"),(3,1),asleep